NO ./textures/north.xpm
SO ./textures/south.xpm
WE ./textures/west.xpm
EA ./textures/east.xpm
F 34,139,34
C 135,206,235

111111111111111111111
10S000000000000000001
100000011101111100001
100000000101   100001
100000000101   111111
100000000001   100001
100000000001   1000001
1000001000011111000001
1000001000000000000001
100001100001111111111
100000000001
100011111111
10001
10001
10001
10001
10001
10001
10001
10001
10001
10001
1000111111
1000000001
1000111001
1000100001
1000000001
1000111111             1111111111111
10001                  1000000000001
10001                  1001111110001
10001                  1001    1001
10001                  1001     1001
10001                  1001    1001
100011111111111111111111001     1001
100010000000000000000000001    1001
100010000001111111111111111     1001
10001110000001                 100001
10000011000001                10000001
11111000000001               1000000001
10000000000001                10000001
10111111111111                 100001
101                             1001
101111111111111111111111111111111001
100000000000000000000000000000000001
111111111111111111111111111111111111