NO ./textures/north.xpm
SO ./textures/south.xpm
WE ./textures/west.xpm
EA ./textures/east.xpm
F 220,100,0
C 225,30,0

111111111111
1000000000N1
100110011101
100110000101
100000000101
101000000001
101000000001
100000100001
100000100001
100001100001
100000000001
111111111111
